############################
#                    #      #
#  # #  
#                   #
#   #   
#       
# ##### 
#   #  ####
#              ############
#
#
#               ####
##
#x
#############################